................
.t............t.
................
....2gg1........
................
................
.........2gg1...
.......i........
................
...2gg1.........
................
...............e
2gggggggggggggg1