................
................
................
....2gg1........
................
................
.5.......2gg1...
.....5..........
................
...2gg1.........
................
................
2gggggggggggggg1