................
................
................
....2gg1........
................
................
....p....2gg1...
................
................
...2gg1.........
................
................
2gggggggggggggg1