................
.t............t.
................
.spd........spd.
................
.......sd.......
................
................
.sppd......sppd.
................
...............e
sppppppppppppppd
................