..........
..........
..rr......
...pgg....
.....pbb..
..........
..........
..........